"filename", "language", "C++", "GLSL", "comment", "blank", "total"
"/home/rajdeep/Projects/the_graviton_project/src/renderer/camera.cpp", "C++", 58, 0, 0, 25, 83
"/home/rajdeep/Projects/the_graviton_project/src/renderer/camera.hpp", "C++", 26, 0, 0, 14, 40
"/home/rajdeep/Projects/the_graviton_project/src/renderer/fShader.glsl", "GLSL", 0, 9, 7, 9, 25
"/home/rajdeep/Projects/the_graviton_project/src/renderer/gl_util.cpp", "C++", 54, 0, 0, 21, 75
"/home/rajdeep/Projects/the_graviton_project/src/renderer/gl_util.hpp", "C++", 14, 0, 0, 5, 19
"/home/rajdeep/Projects/the_graviton_project/src/renderer/mesh.cpp", "C++", 121, 0, 0, 55, 176
"/home/rajdeep/Projects/the_graviton_project/src/renderer/mesh.hpp", "C++", 34, 0, 0, 13, 47
"/home/rajdeep/Projects/the_graviton_project/src/renderer/models.cpp", "C++", 327, 0, 40, 92, 459
"/home/rajdeep/Projects/the_graviton_project/src/renderer/models.hpp", "C++", 9, 0, 0, 5, 14
"/home/rajdeep/Projects/the_graviton_project/src/renderer/render_component.cpp", "C++", 56, 0, 1, 35, 92
"/home/rajdeep/Projects/the_graviton_project/src/renderer/render_component.hpp", "C++", 28, 0, 0, 11, 39
"/home/rajdeep/Projects/the_graviton_project/src/renderer/shader.cpp", "C++", 77, 0, 9, 26, 112
"/home/rajdeep/Projects/the_graviton_project/src/renderer/shader.hpp", "C++", 4, 0, 0, 3, 7
"/home/rajdeep/Projects/the_graviton_project/src/renderer/test.cpp", "C++", 31, 0, 1, 17, 49
"/home/rajdeep/Projects/the_graviton_project/src/renderer/texture.cpp", "C++", 90, 0, 25, 30, 145
"/home/rajdeep/Projects/the_graviton_project/src/renderer/texture.hpp", "C++", 8, 0, 0, 0, 8
"/home/rajdeep/Projects/the_graviton_project/src/renderer/vShader.glsl", "GLSL", 0, 13, 6, 4, 23
"Total", "-", 937, 22, 89, 365, 1413